using System;
using System.Collections.Generic;
using System.Linq;
using System.Text;
using System.Threading.Tasks;

namespace Pacman
{
    public class Map
    {
        string[,] map =

            {

                    {"#","#","#","#","#","#","#","#","#","#","#","#","#","#","#","#","#","#","#","#","#","#","#","#","#","#","#","#","#","#","#","#","#","#","#"},
                    {"#","*",".",".",".",".",".",".",".",".",".",".",".",".",".",".",".","#",".",".",".",".",".",".",".",".",".",".",".",".",".",".",".","*","#"},
                    {"#",".","#","#","#","#","#","#",".","#","#","#","#","#","#","#",".","#",".","#","#","#","#","#","#","#",".","#","#","#","#","#","#",".","#"},
                    {"#",".","#"," "," "," "," ","#",".","#"," "," "," "," "," ","#",".","#",".","#"," "," "," "," "," ","#",".","#"," "," "," "," ","#",".","#"},
                    {"#",".","#"," "," "," "," ","#",".","#"," "," "," "," "," ","#",".","#",".","#"," "," "," "," "," ","#",".","#"," "," "," "," ","#",".","#"},
                    {"#",".","#","#","#","#","#","#",".","#","#","#","#","#","#","#",".","#",".","#","#","#","#","#","#","#",".","#","#","#","#","#","#",".","#"},
                    {"#",".",".",".",".",".",".",".",".",".",".",".",".",".",".",".",".",".",".",".",".",".",".",".",".",".",".",".",".",".",".",".",".",".","#"},
                    {"#",".","#","#","#","#","#","#",".","#","#"," ","#","#","#","#","#","#","#","#","#","#","#"," ","#","#",".","#","#","#","#","#","#",".","#"},
                    {"#",".",".",".",".",".",".",".",".","#","#"," "," "," "," "," "," "," "," "," "," "," "," "," ","#","#",".",".",".",".",".",".",".",".","#"},
                    {"#","#","#","#","#","#","#","#",".","#","#"," ","#","#","#","#"," "," "," ","#","#","#","#"," ","#","#",".","#","#","#","#","#","#","#","#"},
                    {" "," "," "," "," "," "," ","#",".","#","#"," ","#"," "," "," "," "," "," "," "," "," ","#"," ","#","#",".","#"," "," "," "," "," "," "," "},
                    {" "," "," "," "," "," "," ","#",".","#","#"," ","#"," "," "," "," "," "," "," "," "," ","#"," ","#","#",".","#"," "," "," "," "," "," "," "},
                    {"#","#","#","#","#","#","#","#","."," "," "," ","#"," "," "," "," "," "," "," "," "," ","#"," "," "," ",".","#","#","#","#","#","#","#","#"},
                    {"#",".",".",".",".",".",".",".",".","#","#"," ","#"," "," "," "," "," "," "," "," "," ","#"," ","#","#",".",".",".",".",".",".",".",".","#"},
                    {"#","#","#","#","#","#","#","#",".","#","#"," ","#"," "," "," "," "," "," "," "," "," ","#"," ","#","#",".","#","#","#","#","#","#","#","#"},
                    {" "," "," "," "," "," "," ","#",".","#","#"," ","#","#","#","#","#","#","#","#","#","#","#"," ","#","#",".","#"," "," "," "," "," "," "," "},
                    {" "," "," "," "," "," "," ","#",".","#","#"," "," "," "," "," "," "," "," "," "," "," "," "," ","#","#",".","#"," "," "," "," "," "," "," "},
                    {"#","#","#","#","#","#","#","#",".","#","#"," ","#","#","#","#","#","#","#","#","#","#","#"," ","#","#",".","#","#","#","#","#","#","#","#"},
                    {"#",".",".",".",".",".",".",".",".",".",".",".",".",".",".",".",".","#",".",".",".",".",".",".",".",".",".",".",".",".",".",".",".",".","#"},
                    {"#",".","#","#","#","#","#","#",".","#","#","#","#","#","#","#",".","#",".","#","#","#","#","#","#","#",".","#","#","#","#","#","#",".","#"},
                    {"#",".","#","#","#","#","#","#",".",".",".",".",".",".",".",".","."," ",".",".",".",".",".",".",".",".",".","#","#","#","#","#","#",".","#"},
                    {"#",".",".",".",".",".","#","#",".","#","#",".","#","#","#","#","#","#","#","#","#","#","#",".","#","#",".","#","#",".",".",".",".",".","#"},
                    {"#","#","#","#","#",".","#","#",".","#","#",".","#","#","#","#","#","#","#","#","#","#","#",".","#","#",".","#","#",".","#","#","#","#","#"},
                    {"#",".",".",".",".",".",".",".",".","#","#",".",".",".",".",".",".","#",".",".",".",".",".",".","#","#",".",".",".",".",".",".",".",".","#"},
                    {"#",".","#","#","#","#","#","#","#","#","#","#","#","#","#","#",".","#",".","#","#","#","#","#","#","#","#","#","#","#","#","#","#",".","#"},
                    {"#",".","#","#","#","#","#","#","#","#","#","#","#","#","#","#",".","#",".","#","#","#","#","#","#","#","#","#","#","#","#","#","#",".","#"},
                    {"#","*",".",".",".",".",".",".",".",".",".",".",".",".",".",".",".",".",".",".",".",".",".",".",".",".",".",".",".",".",".",".",".","*","#"},
                    {"#","#","#","#","#","#","#","#","#","#","#","#","#","#","#","#","#","#","#","#","#","#","#","#","#","#","#","#","#","#","#","#","#","#","#"}

            };

        public string[,] GetMap
        {
            get { return map; }
        }

    }

    public enum MapElements
    {
        Wall,
        Dot,
        Star,
        Empty,
        Pacman,
        Ghost
    }
}
